Phụng tiên Phoenicia
Long thần Serphont

Azathoth -> Chúa tể hư không
Remmi -> Hầu cận của Azathoth

Thế giới -> Ende

Deino Draco - Galadriel
Wolfrey Flammel - Pelicia


Làng Noth - trưởng làng Noth Lynel / nhíp chính Nethorn cho đến 818 TCN.

Zweislis - Quái vật hư không arc 1
Azathoth - Chúa tể hư không
Bộ lạc Avalon -> Đã sụp do và sát nhập vào Noth
Bộ lạc Noxi -> Đã sụp đỗ và sát nhập vào Noth.

Nothern -> Nhíp chính Noth Lynel
Kansass -> Vua Duskland.
Leonair -> Nữ vương Houdoom.
Midst   -> Vua William Welhelm.
Gunthur -> Vua Anthony Gunthur.
Bulgar  -> Isaki Bulgar.
Madalia -> Vua Gam Madalia.

Chifuyu - Nữ bang chủ liên bang Celest, bà cũng là mẹ của Pelicia.


Dãy Sinister phân chia Bắc - Trung
Sông Pierre phân chia Trung - Nam

Liên bang Vulcanon
Thánh quốc Helya
Vương quốc Brutanbul


Willy Tyburr => Mạn tây Valentine

Quadmire Junking -> Thủ lĩnh những kẻ lưu đày

George Eisenguard -> Vua Eisenguard
Astaroth Williams -> Vua Astaroth

Clint -> Thợ rèn trưởng Camute
Harley -> Đại diện ngành công nghiệp nhẹ Camute
Harvey -> Viện trưởng Camute
Emily -> Trưởng pháp sư đoàn.
Elena -> Chỉ huy trưởng cục tình báo


